NO ./path_to_the_north_texture   
SO ./path_to_the_south_texture
WE ./path_to_the_west_texture
EA ./path_to_the_east_texture

F 255,226,255
C 220,200,0

111111111111111111111
10000W000000000000001
100010000000100000001
100000100001000000001
10001100000000000011
100001010010000000001
100010100101000000001
111111111111111111111