NO ./path_to_the_north_texture   
SO       ./path_to_the_south_texture
WE ./path_to_the_west_texture
EA ./path_to_the_east_texture

F 255,226,255
C 220,200,0

111111111111111111111
100000000000000000001
100000000000100000001
100000000001000000001
1000000000N0000000011
100000000000000000001
100000000000000000001
111111111111111111111
