111111111111111111111111111111111
100000000011000000000000111101111
101100000111000000000000111111111
100100000000000000000000111111111
111111111011000001110000000000001
100000000011000001110111110111111
111101111111110111000000100011111
111101110111110111010100100011111
110000001101010111000000100011111
10000000000000001100000010001111 
100000000000000011010100100011111
11000001110101011111011110N011111
111101111110101101111010001111111
11111111111111111111111111111111