NO ./path_to_the_north_texture   
SO       ./path_to_the_south_texture
WE ./path_to_the_west_texture
EA ./path_to_the_east_texture

F 255,226,255
C 220,200,0

1111111111111
1000000000001
10W0000000011
1111111111111
