NO ./path_to_the_north_texture   

C 10,100,9


SO ./path_to_the_south_texture
WE ./path_to_the_west_texture

F 150,226,26

EA ./path_to_the_east_texture






       1111111111111111111111111111
       100000000011000000000000001
       111011000001110000000000001
       10010000000000000000000011
111111111011000001110000000000001
100000000011000001110111111111111
11110111111111011100000010001111111 1111111
11110111111111011101010010001000001111111111
11000000110101011100000010011111111111111111
10000000000000001100000010001111111111111111
100000000000000011010100100011111111111111111
1100S001110101011111011110001111111111111111
11110111 1110101 1011110100011111111000011111
11111111 1111111 111111111111  1 111111111111