    1111111111111111111111111111111111111
        100000000011000000000000101111
        101100000111000000100000111111
        1001000000000000000001001
11111111101100000111000000000111
11111111101100000111000000000111
100000000011000001110111110111101
111101111111110111000000100011111
1111011111111101110101001000101
110000001101010111000000100011
1000100000011000000100011111
10000000000000001101010010001
11000001110101011111011110N0111
1111011101110101010111101000101
111111111111111111111111111111