11111111111111111111
10000000000010000001
110000000N00000000E1
10000000000000010001
11111111111111111111