NO textures/yoamzil.png
SO textures/omakran.png
WE textures/rouali.png
EA textures/mamazzal.png

F 137,95,32
C 15,25,80

1111111111111111111111111111
100000000011000000000000001
111011000001110000000000001
10010000000000000000000111111111
111111111011000001110000000000001
100000000011000001110111111111111
11110111111111011100000010001
11110111111111011101010010001
1100000011W10101110000001001
1000000000000000110000010001
10000000000000001101010010001
1100000111010101111101111000111
  1111011111110101 101111010001
    11111111 1111111111111111111 